Slang	Associated Drug
151s	crack cocaine
357s	hydrocodone (norco®, vicodin®, lorcet®)
501s	crack cocaine
512s	"acetaminophen and oxycodone combination (percocet®); oxycodone
(oxycontin®, roxicodone®, oxaydo®)"
abajo	heroin
abby	amphetamine and dextroamphetamine combination (adderall®)
a-bomb	heroin mixed with marijuana
abyss	synthetic cannabinoids
abyssian tea	khat
acapulco gold	marijuana
acapulco red	marijuana
accordion	methamphetamine
ace of spades	synthetic cannabinoids
aceite	lsd (lysergic acid diethylamide)
acelerador	amphetamine
acelide	lsd (lysergic acid diethylamide)
achivia	heroin
acid	lsd (lysergic acid diethylamide)
acido	lsd (lysergic acid diethylamide)
adam	ecstasy/mdma/molly
addy	amphetamine and dextroamphetamine combination (adderall®)
adidas	cocaine
adormidera	heroin
african black	marijuana
african bush	marijuana
african salad	khat
ah-pen-yen	opium
airplane	marijuana
ak-47	synthetic cannabinoids
alfalfa	marijuana
alfombra	marijuana
alice	lsd (lysergic acid diethylamide); psilocybin mushrooms
alice b toklas	marijuana
alien sex fiend	pcp mixed with heroin
all-american drug	cocaine
all-star	marijuana
almohada	marijuana
amarilla	heroin
amnesia	synthetic cannabinoids
amoeba	pcp (phencyclidine)
amps	"amphetamine; amphetamine and dextroamphetamine combination
(adderall®)"
ancla	cocaine
anestesia de
caballo"	heroin mixed with the horse anesthetic xylazine
angel	pcp (phencyclidine)
angel dust	pcp (phencyclidine)
angel hair	pcp (phencyclidine)
angel mist	pcp (phencyclidine)
angel poke	pcp (phencyclidine)
angel powder	cocaine
angels in a sky	lsd (lysergic acid diethylamide)
angie	cocaine
angola	marijuana
animal	lsd (lysergic acid diethylamide)
animal cookies	hydroponic marijuana
animal tranquilizer	pcp (phencyclidine)
animals	cocaine
antifreeze	heroin
apache	cocaine; fentanyl and fentanyl derivatives
apodo	cocaine; heroin
apple jack	crack cocaine
aqua	methamphetamine
arizona	marijuana
arnolds	steroids
arpon	heroin
arriba	cocaine
arroz	methamphetamine
ashes	marijuana
assembled	crystal meth
asshy larry	pcp (phencyclidine)
atomic blast	synthetic cannabinoids
a-train	amphetamine and dextroamphetamine combination (adderall®)
audi	cocaine
aunt emma	opium
aunt hazel	heroin
aunt mary	marijuana
aunt nora	cocaine
auntie	opium
aurora borealis	pcp (phencyclidine)
avandaro	lsd (lysergic acid diethylamide)
avocado	heroin
azucar	cocaine; heroin
baby	marijuana
baby powder	cocaine
baby slits	ecstasy/mdma/molly
baby t	crack cocaine
backbreaker	lsd mixed with strychnine
bad seed	heroin
baja corte	diluted heroin
bale	marijuana
ballot	heroin
bambalachacha	marijuana
bananas	"acetaminophen and oxycodone combination (percocet®); hydrocodone
(norco®, vicodin®, lorcet®)
barbara jean	marijuana
bareta	marijuana
barrato	cocaine
barrel	lsd (lysergic acid diethylamide)
barry farrell	ketamine (ketalar®)
bars	alprazolam (xanax®)
bart simpson	lsd (lysergic acid diethylamide)
base	crack cocaine
baseball	crack cocaine
bash	marijuana
basketball	heroin
basuco	cocaine
basura	heroin
bath blow	synthetic cathinones
bath salts	synthetic cathinones
battery acid	lsd (lysergic acid diethylamide)
batu	methamphetamine
bazooka	cocaine paste mixed with marijuana; crack cocaine
b-bombs	amphetamine
bc budd	marijuana
beach	cocaine
beam me up	crack cocaine
beans	"amphetamine; ecstasy/mdma/molly; oxycodone (oxycontin®,
roxicodone®, oxaydo®)"
beast	heroin; lsd (lysergic acid diethylamide)
beautiful boulders	crack cocaine
beemer	crack cocaine
beers	methamphetamine
begok	methamphetamine
belushi	cocaine mixed with heroin
bennies	amphetamine
benzos	alprazolam (xanax®); amphetamine; clonazepam (klonopin®)
bernice	cocaine
bernie	marijuana
bernie’s flakes	cocaine
bernie’s gold dust	cocaine
beyonce	heroin
bhang	marijuana
bhno	marijuana concentrates/hash oil
bicycle handle bars	alprazolam (xanax®)
bicycle parts	alprazolam (xanax®)
big bag	heroin
big bang	synthetic cannabinoids
big bird	cocaine
big bloke	cocaine
big c	cocaine
big chief	mescaline/peyote
big d	lsd (lysergic acid diethylamide)
big flake	cocaine
big h	heroin
big harry	heroin
big o	opium
big pillows	marijuana
big rush	cocaine
biggy	marijuana
biker’s coffee	methamphetamine
bill blass	crack cocaine
billie hoke	cocaine
bings	crack cocaine
bionic	marijuana mixed with pcp
bird	cocaine; heroin
birdie powder	cocaine; heroin
birria	fentanyl mixed with heroin; heroin
birria blanca	heroin
black	heroin; opium
black acid	lsd mixed with pcp
black and whites	amphetamine
black bart	marijuana
black beauties	amphetamine
black birds	amphetamine
black bitch	heroin
black bombers	amphetamine
black button	mescaline/peyote
black glass	marijuana concentrates/hash oil
black goat	heroin
black gold	marijuana
black magic smoke	synthetic cannabinoids
black mamba	synthetic cannabinoids
black maria	marijuana
black mollies	amphetamine
black olive	heroin
black paint	heroin
black pearl	heroin
black pill	opium
black rock	crack cocaine
black russian	opium mixed with hashish
black sheep	heroin
black shirt	heroin
black star	lsd (lysergic acid diethylamide)
black sunshine	lsd (lysergic acid diethylamide)
black tabs	lsd (lysergic acid diethylamide)
black tar	heroin
black whack	pcp (phencyclidine)
blacks	amphetamine
blanca nieves	cocaine
blanco	cocaine; heroin
blanco de españa	lsd (lysergic acid diethylamide)
blast	cocaine
blaze	synthetic cannabinoids
blind squid	ketamine (ketalar®)
bliss	synthetic cannabinoids; synthetic cathinones
blizzard	cocaine
blocks	cocaine
blonde	cocaine; fentanyl and fentanyl derivatives
blondie	marijuana
bloom	synthetic cathinones
blotter acid	lsd (lysergic acid diethylamide)
blotter cube	lsd (lysergic acid diethylamide)
blow	cocaine; synthetic cathinones
blow dope	heroin
blowcaine	crack cocaine
blowout	crack cocaine; ghb (gamma-hydroxybutyric acid)
blue	"acetaminophen and oxycodone combination (percocet®); crack
cocaine; heroin; methamphetamine"
blue acid	lsd (lysergic acid diethylamide)
blue barrel	lsd (lysergic acid diethylamide)
blue bell ice cream	methamphetamine
blue boys	amphetamine
blue caps	mescaline/peyote
blue chair	lsd (lysergic acid diethylamide)
blue cheer	lsd (lysergic acid diethylamide)
blue cheese	marijuana; synthetic cannabinoids
blue crush	marijuana
blue diamond	fentanyl and fentanyl derivatives
blue dolphin	fentanyl and fentanyl derivatives
blue dream	marijuana
blue dynamite	acetaminophen and oxycodone combination (percocet®)
blue heaven	lsd (lysergic acid diethylamide)
blue hero	heroin
blue jeans	marijuana
blue kisses	ecstasy/mdma/molly
blue madman	pcp (phencyclidine)
blue meanies	psilocybin mushrooms
blue microdots	lsd (lysergic acid diethylamide)
blue mist	lsd (lysergic acid diethylamide)
blue moon	lsd (lysergic acid diethylamide)
blue sage	marijuana
blue silk	synthetic cathinones
blue sky	lsd (lysergic acid diethylamide)
blue star	lsd (lysergic acid diethylamide); pcp (phencyclidine)
blue superman	ecstasy/mdma/molly
blue tabs	lsd (lysergic acid diethylamide)
blueberries	acetaminophen and oxycodone combination (percocet®)
blueberry	marijuana
blues	"fentanyl and fentanyl derivatives; oxycodone (oxycontin®,
roxicodone®, oxaydo®)"
board	cocaine
boat	pcp (phencyclidine)
bobo	cocaine; crack cocaine
bobo bush	marijuana
bolitas	cocaine
bolivian marching
powder"	cocaine
bolo	crack cocaine
bomb	crack cocaine
bomba	lsd (lysergic acid diethylamide)
bombay blue	synthetic cannabinoids
bombita	amphetamine; heroin mixed with cocaine
bombs	ecstasy/mdma/molly
bombs away	heroin
bone	crack cocaine
bone crusher	crack cocaine
bonita	heroin
boo-boo	crack cocaine
boom	marijuana
boomers	psilocybin mushrooms
booty juice	ecstasy/mdma/molly dissolved in liquid
bottles	methamphetamine
boulder	crack cocaine
boxes	buprenorphine and naloxone combination (suboxone®)
bozo	heroin
brain freeze	synthetic cannabinoids
brain ticklers	amphetamine
branches	marijuana
brea negra	heroin
"breakfast of
champions"	crack cocaine
brick gum	heroin
bricks	alprazolam (xanax®)
brisa	cocaine
britton	mescaline/peyote
broccoli	marijuana
brown	heroin
brown bomber	lsd (lysergic acid diethylamide)
brown crystal	heroin
brown dots	lsd (lysergic acid diethylamide)
brown rhine	heroin
brown sugar	heroin
brownies	amphetamine
bruno mars	ghb (gamma-hydroxybutyric acid)
bubble gum	crack cocaine; heroin
bubble hash	marijuana concentrates/hash oil
bubbles	synthetic cathinones
bucio	methamphetamine
bud light	methamphetamine
budda	marijuana
budder	marijuana concentrates/hash oil
bullion	crack cocaine
bumblebees	amphetamine
bump	cocaine; crack cocaine; methamphetamine
bupes	buprenorphine and naloxone combination (suboxone®)
burrito	heroin
burritos verdes	marijuana
bush	marijuana
busy bee	pcp (phencyclidine)
butane hash oil	marijuana concentrates/hash oil
butane honey oil	marijuana concentrates/hash oil
butt naked	pcp (phencyclidine)
butter	fentanyl and fentanyl derivatives; heroin
buttons	"acetaminophen and oxycodone combination (percocet®); mescaline/
peyote; oxycodone (oxycontin®, roxicodone®, oxaydo®);  psilocybin
mushrooms
buzz haze	synthetic cannabinoids
caballo	cocaine; heroin
caballo negro	heroin
cabbage	marijuana
caca	cocaine; heroin
cactus	mescaline/peyote
cadillac	cocaine; pcp (phencyclidine)
café	heroin; marijuana
cajeta	heroin
cajita	marijuana
cajitas	methamphetamine
california sunshine	lsd (lysergic acid diethylamide); marijuana
camara	marijuana
canadian black	marijuana
candy	crack cocaine; ecstasy/mdma/molly
capital h	heroin
caps	crack cocaine; psilocybin mushrooms
cardio	white heroin
carga	heroin
caro	heroin
cartwheels	amphetamine
casper the ghost	crack cocaine
cat food	ketamine (ketalar®)
cat valium	ketamine (ketalar®)
catha	khat
catnip	marijuana
caviar	crack cocaine; marijuana concentrates/hash oil
cbd oil	marijuana concentrates/hash oil
c-dust	cocaine
cecil	cocaine
cement	cocaine; heroin
certificada	pure heroin
chalk	amphetamine; methamphetamine
champiñones	psilocybin mushrooms
chandelier	methamphetamine
chandoo	opium
chapopote	heroin
charlie	cocaine; heroin
charlie horse	heroin
chat	khat
chavalone	methamphetamine
chavo	heroin
cheap basting	crack cocaine
cheeba	marijuana
cheese	heroin; marijuana
chernobyl	marijuana
cherry bomb	synthetic cannabinoids
cherry dome	lsd (lysergic acid diethylamide)
cherry meth	ghb (gamma-hydroxybutyric acid)
chevy	cocaine
chewies	crack cocaine
cheyenne	cocaine
chica	cocaine
chicago green	marijuana
chicantas	cocaine
chicken	methamphetamine
chicken feed	methamphetamine
chicken powder	amphetamine; methamphetamine
chicle	heroin
chiclosa	heroin
chief	lsd (lysergic acid diethylamide)
chill	synthetic cannabinoids
china	heroin; opium
china blanca	white heroin
china cat	heroin
china girl	fentanyl and fentanyl derivatives
china town	fentanyl and fentanyl derivatives
china white	fentanyl and fentanyl derivatives; heroin
chinese	fentanyl and fentanyl derivatives
chinese buffet	fentanyl and fentanyl derivatives; white heroin
chinese dragons	lsd (lysergic acid diethylamide)
chinese food	fentanyl and fentanyl derivatives; heroin
chinese molasses	opium
chinese red	heroin
chinese tobacco	opium
chingy	crack cocaine
chinos	cocaine
chip	heroin
chippie	marijuana
chistosa	marijuana
chiva	cocaine; heroin
chiva blanca	heroin
chiva loca	heroin mixed with fentanyl
chiva negra	heroin
chivones	heroin
chochos	amphetamine
chocolate	heroin; opium
chocolate balls	heroin
chocolate chips	ecstasy/mdma/molly
chocolate shake	heroin
chocolates	amphetamine
choko	heroin
chorizo	heroin
chris	methamphetamine
christina	amphetamine
christine	methamphetamine
christmas tree	marijuana
christmas trees	amphetamine and dextroamphetamine combination (adderall®)
christy	methamphetamine
chrome	synthetic cannabinoids
chronic	marijuana
chunk	amphetamine
churro	marijuana
churro negro	heroin
chutazo	heroin
cielo	cocaine
cigars	marijuana
circles	flunitrazepam (rohypnol®)
citrol	marijuana
clarity	ecstasy/mdma/molly
clear	methamphetamine
clear kind	cocaine
clear tires	cocaine
clicker	crack cocaine
cliffhanger	pcp (phencyclidine)
climax	crack cocaine
clockwork orange	synthetic cannabinoids
clothing cleaner	methamphetamine
cloud	crack cocaine
cloud 10	synthetic cannabinoids
cloud 9	synthetic cathinones
cloud nine	crack cocaine
coast-to-coasts	amphetamine
coca	cocaine
coca-cola	cocaine
cocazo	cocaine
coco	heroin
coconut	cocaine
coffee	heroin; lsd (lysergic acid diethylamide)
cohete	heroin
coke	cocaine
cola	cocaine; marijuana
cold	methamphetamine
cold one	methamphetamine
colorado	cocaine
colorado cocktail	marijuana
colorado rockies	methamphetamine
colorines	lsd (lysergic acid diethylamide)
columbo	pcp (phencyclidine)
comida	heroin; cocaine
comida dulce	cocaine
conductor	lsd (lysergic acid diethylamide)
connie	cocaine
cookie	cocaine; hydroponic marijuana
cookies	crack cocaine
co-pilot	"amphetamine; amphetamine and dextroamphetamine combination
(adderall®)"
cosa	cocaine
cosmic beast	synthetic cathinones
coso	cocaine
cosos	cocaine
cotorritos	marijuana
cotton	oxycodone (oxycontin®, roxicodone®, oxaydo®)
cowboy kush	synthetic cannabinoids
cozmos	pcp (phencyclidine)
crank	methamphetamine
crazy	fentanyl and fentanyl derivatives
crazy eddie	pcp (phencyclidine)
crazy oke	pcp (phencyclidine)
crazy one	fentanyl and fentanyl derivatives
crazy weed	marijuana
cream	methamphetamine
creeper bud	marijuana
crib	crack cocaine
cri-cri	methamphetamine
crink	methamphetamine
crippy	marijuana
crisco	methamphetamine
crisscross	amphetamine
crissy	methamphetamine
cross roads	amphetamine
cross tops	amphetamine
crosses	amphetamine
crow	cocaine
crown cap	heroin
crumble	marijuana concentrates/hash oil
crunch and munch	crack cocaine
crusty treats	cocaine
cruz	opium
crying weed	marijuana
crypto	methamphetamine
crystal skull	synthetic cannabinoids
crystalline	marijuana concentrates/hash oil; methamphetamine
cuadro	methamphetamine; cocaine
cubes	psilocybin mushrooms
cucuy	pcp (phencyclidine)
culican	marijuana
curley hair	heroin
cyclones	pcp (phencyclidine)
d.o.a.	heroin
dabs	marijuana concentrates/hash oil
dance fever	fentanyl and fentanyl derivatives
dancing shoes	ecstasy/mdma/molly
dank	marijuana
dark	heroin
dark girl	heroin
dark kind	heroin
date rape drug	flunitrazepam (rohypnol®)
dead man	synthetic cannabinoids
dead on arrival	heroin
death valley	cocaine
debs	amphetamine
decadence	ecstasy/mdma/molly
designer jeans	cocaine
detroit pink	pcp (phencyclidine)
devil	crack cocaine
devil smoke	crack cocaine
devil’s dandruff	cocaine
devil’s lettuce	marijuana
devil’s venom	synthetic cannabinoids
dexies	amphetamine
diablos	amphetamine
diamond	methamphetamine
diamonds	amphetamine; cocaine
dice	crack cocaine
diente	cocaine
dienton	cocaine
diesel	cocaine; heoin; marijuana
diet coke	methylphenidate (ritalin®, concerta®, daytrana®)
diet pills	amphetamine
dillies	hydromorphone (dilaudid®)
dimba	marijuana
dime special	crack cocaine
dinkie dow	marijuana
diosa blanca	cocaine
diosa verde	marijuana
dipper	marijuana concentrates/hash oil; pcp (phencyclidine)
dirt	heroin
dirt grass	marijuana
dirty basing	crack cocaine
dirty fentanyl	crack cocaine mixed with fentanyl
disco biscuits	ecstasy/mdma/molly
ditch weed	marijuana
dizz	marijuana
djamba	marijuana
doctor	ecstasy/mdma/molly
dody	marijuana
dog food	heroin
doggie	heroin
dojo	marijuana
dolls	amphetamine
domestic	marijuana
domex	ecstacy mixed with pcp
dominoes	amphetamine
dona blanca	cocaine
dones	hydrocodone (norco®, vicodin®, lorcet®)
donkey	ketamine (ketalar®)
donna juana	marijuana
doobie	marijuana
doojee	heroin
dope	heroin
dopium	opium
dorado	heroin
dots	lsd (lysergic acid diethylamide)
double bubble	cocaine
double cross
drivers"	amphetamine
double dome	lsd (lysergic acid diethylamide)
double letters	cocaine
double yoke	crack cocaine
dove	cocaine
dover’s powder	opium
down	heroin
downtown	heroin
downtown brown	marijuana
dr. feel good	synthetic cannabinoids
drag weed	marijuana
dragon	fentanyl and fentanyl derivatives; heroin
dragon eye	synthetic cannabinoids
dragon’s breath	fentanyl and fentanyl derivatives
drank	promethazine
dream	cocaine
dream gum	opium
dream stick	opium
dreamer	morphine
dreams	opium
dreck	heroin
droco	hydrocodone (norco®, vicodin®, lorcet®)
drone	synthetic cathinones
drop	ecstasy/mdma/molly
droski	hydroponic marijuana
dry high	marijuana
dulces	amphetamine; cocaine
dummy dust	pcp (phencyclidine)
dunk	methamphetamine
duracell	cocaine
durazno	cocaine
durin	crack cocaine
duro	cocaine
dust	cocaine; pcp (phencyclidine)
dust joint	pcp (phencyclidine)
dust of angels	pcp (phencyclidine)
dynamite	heroin
dyno	heroin
ear wax	marijuana concentrates/hash oil
earth blend	synthetic cannabinoids
easing powder	opium
eastside player	crack cocaine
easy lay	ghb (gamma-hydroxybutyric acid)
e-bomb	ecstasy/mdma/molly
edibles	marijuana concentrates/hash oil
el cid	lsd (lysergic acid diethylamide)
el diablo	heroin
el gata diablo	methamphetamine
electric kool aid	lsd (lysergic acid diethylamide)
elefante blanco	lsd (lysergic acid diethylamide)
elefante pata	marijuana
elephant	pcp (phencyclidine)
"elephant
tranquilizer"	pcp (phencyclidine)
ellis day	lsd (lysergic acid diethylamide)
embalming fluid	pcp (phencyclidine)
enail	marijuana concentrates/hash oil
endo	marijuana
energy-1	synthetic cathinones
engines	heroin
enigizer	pcp (phencyclidine)
enrique grande	heroin
ercs	acetaminophen and oxycodone combination (percocet®)
errl	marijuana concentrates/hash oil
escama	cocaine
escoba	marijuana
escorpino	cocaine
esquina	heroin
esquinilla	heroin
essence	ecstasy/mdma/molly
everclear	ghb (gamma-hydroxybutyric acid)
evil sister	methamphetamine
exodus	synthetic cannabinoids
explosion	synthetic cathinones
extract	marijuana concentrates/hash oil
extreme	synthetic cannabinoids
eye glasses	methamphetamine
eye opener	crack cocaine
facebook	fentanyl mixed with heroin in pill form
fairy dust	heroin
fake bake	synthetic cannabinoids
fake stp	pcp (phencyclidine)
falopa	cocaine
famous dimes	crack cocaine
fantasy g	ghb (gamma-hydroxybutyric acid)
fat bags	crack cocaine
fattie	marijuana
fef1	cocaine
fent	fentanyl and fentanyl derivatives
fenty	fentanyl and fentanyl derivatives
fichas	cocaine
fi-do-nie	opium
fields	lsd (lysergic acid diethylamide)
fiesta	cocaine
fifty-one	crack cocaine
fine stuff	marijuana
fire	"cocaine base; fentanyl and fentanyl derivatives; marijuana;
methamphetamine; synthetic cannabinoids
first line	morphine
fish	liquid cocaine
fish scale	cocaine
fish scales	crack cocaine
fives	amphetamine
fizz	methamphetamine
flake	cocaine
flakes	pcp (phencyclidine)
flakka	synthetic cathinones - alpha- pvp
flash	lsd (lysergic acid diethylamide)
flat blues	lsd (lysergic acid diethylamide)
flea market jeans	cocaine
flea powder	heroin
florida snow	cocaine
flour	amphetamine; cocaine
flower	marijuana
flower tops	marijuana
flowers	methamphetamine
fluff	hydrocodone (norco®, vicodin®, lorcet®)
fluffy	marijuana
foco	methamphetamine
food	"cocaine; fentanyl and fentanyl derivatives; white heroin;
methamphetamine"
foolish powder	cocaine; heroin
footballs	alprazolam (xanax®); amphetamine
forget pill	flunitrazepam (rohypnol®)
freddy	fentanyl and fentanyl derivatives
freebase	crack cocaine
freeze	cocaine
french blues	amphetamine
french fries	crack cocaine
friend	fentanyl and fentanyl derivatives
frio	methamphetamine
friskie powder	cocaine
fruit	methamphetamine
fruit candy flavors	synthetic cannabinoids
frula	cocaine
full melt	marijuana concentrates/hash oil
funky buddha	synthetic cannabinoids
funky monkey	synthetic cannabinoids
funtime	cocaine
fuzzy lady	marijuana
gabacho	cocaine
galaxy	cocaine
gallina	marijuana
gallito	marijuana
galloping horse	heroin
gallos	cocaine
gamma oh	ghb (gamma-hydroxybutyric acid)
gamot	heroin
gangster	marijuana
ganja	marijuana
garbage	methamphetamine
garbage rock	crack cocaine
garden	marijuana
garden salad	synthetic cannabinoids
garifa	marijuana
gash	marijuana
gato	cocaine; heroin; marijuana
gauge	marijuana
gear	steroids
geeb	ghb (gamma-hydroxybutyric acid)
geek	crack cocaine
geeked up	amphetamine
genie	synthetic cannabinoids
george smack	heroin
georgia home boy	ghb (gamma-hydroxybutyric acid)
g-force	synthetic cannabinoids
g-funk	methamphetamine
ghana	marijuana
ghost	lsd (lysergic acid diethylamide)
gi joe	synthetic cannabinoids
gift of the sun	cocaine
gifts	methamphetamine
giggle smoke	marijuana
giggle weed	marijuana
gigi	hydroponic marijuana
gina	ghb (gamma-hydroxybutyric acid)
girl	cocaine; fentanyl and fentanyl derivatives; heroin
girl scout cookies	hydroponic marijuana
girlfriend	cocaine
girls	methamphetamine
glad stuff	cocaine
glass	methamphetamine
glob	marijuana concentrates/hash oil
globo	balloon of heroin
gloria	marijuana
goat	heroin
god’s drug	morphine
god’s flesh	psilocybin mushrooms
god’s medicine	opium
go-fast	methamphetamine
go-go	methamphetamine
gold	crack cocaine; marijuana
gold dust	cocaine
gold leaf	marijuana
gold star	marijuana
golden dragon	lsd (lysergic acid diethylamide)
golden girl	heroin
golf ball	crack cocaine
golf balls	lsd (lysergic acid diethylamide)
goma	heroin; opium
gondola	opium
gong	marijuana
good and plenty	heroin
good giggles	marijuana
good h	heroin
goodfella	fentanyl and fentanyl derivatives
goofball	heroin mixed with methamphetamine
goofballs	amphetamine
goofy	lsd (lysergic acid diethylamide)
goog	ecstasy/mdma/molly
goon	pcp (phencyclidine)
goop	ghb (gamma-hydroxybutyric acid)
gorda	heroin
goric	opium
gorilla	marijuana
gorilla glue	marijuana; marijuana concentrates/hash oil
gorilla tab	pcp (phencyclidine)
gorrilla biscuits	pcp (phencyclidine)
gota	lsd (lysergic acid diethylamide)
grand daddy purp	marijuana
grape parfait	lsd (lysergic acid diethylamide)
gras	heroin
grasin	heroin
grass	marijuana
grasshopper	marijuana
gravel	crack cocaine; synthetic cathinones - alpha- pvp
gravy	heroin
gray stuff	fentanyl and fentanyl derivatives
great bear	fentanyl and fentanyl derivatives
great hormones at
bedtime"	ghb (gamma-hydroxybutyric acid)
great tobacco	opium
great white hope	crack cocaine
green	ketamine (ketalar®); marijuana
green apple	ecstasy/mdma/molly
green button	mescaline/peyote
green crack	marijuana
green dream	synthetic cannabinoids
green eyes	marijuana
green goblin	marijuana
green goddess	marijuana
green gold	cocaine
green k	ketamine (ketalar®)
green leaves	pcp (phencyclidine)
"green mercedes
benz"	marijuana
green paint	marijuana
green peace	synthetic cannabinoids
green skunk	marijuana
green tea	pcp (phencyclidine)
green wedge	lsd (lysergic acid diethylamide)
green-eyed girl	marijuana
greenhouse	marijuana
greenies	acetaminophen and oxycodone combination (percocet®); amphetamine
greens	oxycodone (oxycontin®, roxicodone®, oxaydo®)
grenuda	marijuana
greta	marijuana
grey shields	lsd (lysergic acid diethylamide)
"grievous bodily
harm"	ghb (gamma-hydroxybutyric acid)
g-riffic	ghb (gamma-hydroxybutyric acid)
gringa	cocaine
gringito	cocaine
grit	crack cocaine
groceries	crack cocaine; methamphetamine
grout	cocaine
guardada	marijuana
guerillo	cocaine
gueros	cocaine
guitar	cocaine
guma	opium
gummy bears	marijuana
gunga	marijuana
gym candy	steroids
hail	crack cocaine
hairy	heroin
hairy ones	marijuana
half moon	mescaline/peyote
hamburger	cocaine
hamburger helper	crack cocaine
hammer head	synthetic cannabinoids
handlebars	alprazolam (xanax®)
happy dust	cocaine
happy pill	ecstasy/mdma/molly
happy powder	cocaine
happy trails	cocaine
hard	crack cocaine
hard candy	heroin
hard ones	methamphetamine
hardy one	heroin
hare	methamphetamine
harry	heroin
hash	marijuana
hats	heroin; lsd (lysergic acid diethylamide)
hawaiian	marijuana
hawaiian salt	methamphetamine
hawaiian sunshine	lsd (lysergic acid diethylamide)
hawk	lsd (lysergic acid diethylamide)
haze	lsd (lysergic acid diethylamide)
hazel	heroin
h-caps	heroin
head drugs	amphetamine
headlights	lsd (lysergic acid diethylamide)
heady	marijuana concentrates/hash oil
hearts	amphetamine
heaven	cocaine
heaven and hell	pcp (phencyclidine)
heaven dust	cocaine; heroin
heavenly blue	lsd (lysergic acid diethylamide)
heavy	heroin
heavy one	cocaine
heineken	fentanyl and fentanyl derivatives
helen	heroin
helicopter	heroin
helix	synthetic cannabinoids
hell dust	heroin
he-man	fentanyl and fentanyl derivatives
hemp	marijuana
henry	heroin
henry viii	cocaine
herb	marijuana
hercules	heroin
hero	heroin
hielo	methamphetamine
hierba	marijuana
high heat	cocaine
hikori	mescaline/peyote
hikuli	mescaline/peyote
hillbilly heroin	"acetaminophen and oxycodone combination (percocet®); oxycodone
(oxycontin®, roxicodone®, oxaydo®)
hiopon	methamphetamine
hipster	synthetic cannabinoids
hits	lsd (lysergic acid diethylamide)
hocus	opium
hoja	marijuana
holy grail	marijuana
hombre	heroin
homegrown	marijuana
honey oil	ketamine (ketalar®); marijuana concentrates/hash oil
hongos	psilocybin mushrooms
hooch	marijuana
hops	opium
horse	heroin
horse heads	amphetamine
horse tracks	pcp (phencyclidine)
horse tranquilizers	pcp (phencyclidine)
hot dope	heroin
hot ice	methamphetamine
hotcakes	crack cocaine
hubba	crack cocaine
hubbers	methamphetamine
huera	heroin
huerfanito	fentanyl and fentanyl derivatives
hug drug	ecstasy/mdma/molly
hulk	alprazolam (xanax®)
huma	marijuana
humid	fentanyl and fentanyl derivatives
hummers	heroin
hyatari	mescaline/peyote
hydro	marijuana
hydros	hydrocodone (norco®, vicodin®, lorcet®)
hysteria	synthetic cannabinoids
ice cream	methamphetamine
ice cubes	crack cocaine
ice dragon	synthetic cannabinoids
ice water	methamphetamine
ice water hash	marijuana concentrates/hash oil
icehead	methamphetamine
idiot pills	hydrocodone (norco®, vicodin®, lorcet®)
in-betweens	amphetamine
incense	opium
indian boy	marijuana
indian hay	marijuana
insect repellent	synthetic cathinones
instant zen	lsd (lysergic acid diethylamide)
issues	crack cocaine
ivory wave	synthetic cathinones
jackpot	fentanyl and fentanyl derivatives
jale	methamphetamine
jamaican gold	marijuana
jamaican red	marijuana
jelly	cocaine
jelly babies	amphetamine
jelly beans	amphetamine; crack cocaine
jesus christ acid	lsd (lysergic acid diethylamide)
jet fuel	pcp (phencyclidine)
jet k	ketamine (ketalar®)
jewelry cleaner	synthetic cathinones
jive	marijuana
john deere	cocaine
johnny	methylphenidate (ritalin®, concerta®, daytrana®)
johnson	crack cocaine
jojee	heroin
joker	synthetic cannabinoids
jolly beans	amphetamine
jolly green	marijuana
jon-jem	marijuana
joy flakes	cocaine; heroin
joy juice	morphine
joy plant	opium
joy powder	cocaine; heroin
joy smoke	marijuana
juan valdez	marijuana
juanita	marijuana
jug of water	methamphetamine
jugs	amphetamine
juguetes	cocaine
juice	pcp (phencyclidine); promethazine; steroids
juicy leaf	synthetic cannabinoids
jump rope	cocaine
jungle juice	marijuana; synthetic cannabinoids
junk	cocaine; heroin
just chill	synthetic cannabinoids
kabayo	heroin
kaff	marijuana
kaleidoscope	lsd (lysergic acid diethylamide)
kali	marijuana
kangaroo	crack cocaine
kaos	synthetic cannabinoids
kaps	pcp (phencyclidine)
karachi	heroin
karate	heroin
karma	synthetic cannabinoids
kaya	marijuana
k-blast	pcp (phencyclidine)
keller	ketamine (ketalar®)
kelly’s day	ketamine (ketalar®)
kentucky blue	marijuana
khalifa	marijuana
k-hold	ketamine (ketalar®)
kibbles and bits	methylphenidate (ritalin®, concerta®, daytrana®)
kickers	"acetaminophen and oxycodone combination (percocet®); oxycodone
(oxycontin®, roxicodone®, oxaydo®)"
kiddie cocaine	methylphenidate (ritalin®, concerta®, daytrana®)
kiddie coke	methylphenidate (ritalin®, concerta®, daytrana®)
kiff	marijuana
killa	marijuana
killer	pcp (phencyclidine)
killers	oxycodone (oxycontin®, roxicodone®, oxaydo®)
kilter	marijuana
king ivory	fentanyl and fentanyl derivatives
king louie	marijuana
king’s habit	cocaine
king’s tickets	heroin
kit kat	ketamine (ketalar®)
kitty flip	ketamine (ketalar®)
klear	marijuana concentrates/hash oil
kleenex	ecstasy/mdma/molly
knoa gold	marijuana
kokoma	crack cocaine
kong	synthetic cannabinoids
kools	pcp (phencyclidine)
kordell	cocaine
k-pin	clonazepam (klonopin®)
krazy kandy	synthetic cannabinoids
kryp2nite	synthetic cannabinoids
kryptonite	crack cocaine
kumba	marijuana
kush	marijuana; synthetic cannabinoids
k-ways	ketamine (ketalar®)
l.a. glass	methamphetamine
l.a. ice	methamphetamine
la familia	cocaine
la rocha	flunitrazepam (rohypnol®)
la tierra	heroin
la turnaround	amphetamine
ladders	alprazolam (xanax®)
lady	cocaine
lady snow	cocaine
late night	cocaine
laughing grass	marijuana
laughing weed	marijuana
lavada	cocaine
layer cake	synthetic cannabinoids
lazers	psilocybin mushrooms
leaf	cocaine; marijuana
leaky leak	pcp (phencyclidine)
lean	promethazine
leapers	amphetamine
leary	lsd (lysergic acid diethylamide)
lechuga	marijuana
lemon 714	pcp (phencyclidine)
lemon drop	methamphetamine
lemonade	heroin; hydrocodone (norco®, vicodin®, lorcet®)
lemon-lime	marijuana
lemons	methamphetamine
leña	marijuana
lens	lsd (lysergic acid diethylamide)
lenta	heroin
lentejuela	lsd (lysergic acid diethylamide)
lethal weapon	pcp (phencyclidine)
liamba	marijuana
liberties	psilocybin mushrooms
liberty caps	psilocybin mushrooms
libreta	cocaine
lid poppers	"amphetamine; amphetamine and dextroamphetamine combination
(adderall®)"
lifesaver	heroin
light	methamphetamine
light beige	methamphetamine
lightening	amphetamine
lime acid	lsd (lysergic acid diethylamide)
lime pillows	marijuana
limitless	synthetic cannabinoids
line	cocaine
liquid e	ghb (gamma-hydroxybutyric acid)
liquid x	ghb (gamma-hydroxybutyric acid)
little bombs	amphetamine
little green friends	marijuana
little smoke	marijuana; psilocybin mushrooms
live	lsd (lysergic acid diethylamide)
live resin	marijuana concentrates/hash oil
livianas	methamphetamine
llesca	marijuana
lluvia de estrellas	lsd (lysergic acid diethylamide)
loaf	cocaine; marijuana
lobo	marijuana
loco weed	marijuana
lollipop	fentanyl and fentanyl derivatives
looney tunes	lsd (lysergic acid diethylamide)
lorries	hydrocodone (norco®, vicodin®, lorcet®)
loud	marijuana
love	crack cocaine
love affair	cocaine
love boat	pcp (phencyclidine)
love doctor	ecstasy/mdma/molly
love drug	ecstasy/mdma/molly
love flip	mescaline/peyote taken with ecstasy
love nuggets	marijuana
love potion #9	ecstasy/mdma/molly
love trip	ecstasy mixed with mescaline
love weed	marijuana
lover’s speed	ecstasy/mdma/molly
lucas	marijuana
lucy	lsd (lysergic acid diethylamide)
lunar wave	synthetic cathinones
lunch money	flunitrazepam (rohypnol®)
m.j.	marijuana
m-30s	acetaminophen and oxycodone combination (percocet®)
maca flour	cocaine
machinery	marijuana
macoña	marijuana
mad dog	pcp (phencyclidine)
mad hatter	synthetic cannabinoids
mad man	pcp (phencyclidine)
madera	methamphetamine; cocaine
mafafa	marijuana
magic dust	pcp (phencyclidine); psilocybin mushrooms
magic smoke	marijuana
maje	lsd (lysergic acid diethylamide)
malcolm x	ecstasy/mdma/molly
mama coca	cocaine
mamph	methamphetamine
mandango	cocaine
manhattan silver	marijuana
manita	cocaine
manteca	heroin; marijuana
maracachafa	marijuana
maradona	cocaine
marathons	amphetamine
marbol	cocaine
maria	marijuana
marias	heroin
marimba	marijuana
mariquita	marijuana
marrion	heroin
mary ann	marijuana
mary jane	marijuana
mary jones	marijuana
mary warner	marijuana
mary weaver	marijuana
matchbox	marijuana
material	cocaine
matraca	marijuana
maui wowie	marijuana
mayback	cocaine - 62 grams
mayo	cocaine; heroin
mazpan	heroin
m-cat	synthetic cathinones
meal	heroin
mean green	pcp (phencyclidine)
media lata	cocaine
media luna	mescaline/peyote
melcocha	cocaine
mellow yellow	lsd (lysergic acid diethylamide)
menthol	heroin
meow-meow	synthetic cathinones
mercedes	cocaine
mersh	marijuana
mescal	mescaline/peyote
mescapade	mescaline/peyote
meth	methamphetamine
methlies quick	methamphetamine
method	marijuana
mexicali haze	marijuana
mexican brown	heroin; marijuana
mexican crack	methamphetamine
mexican crank	methamphetamine
mexican green	marijuana
mexican red	marijuana
mexican valium	flunitrazepam (rohypnol®)
mezcakuba	mescaline/peyote
mica	lsd (lysergic acid diethylamide)
microdot	lsd (lysergic acid diethylamide); mescaline/peyote
micropunto azul	white tablet with drop of blue lsd
micropunto morado	white tablet with drop of purple lsd
midnight oil	opium
mighty quinn	lsd (lysergic acid diethylamide)
mile high	synthetic cannabinoids
milk	cocaine
milonga	cocaine
mind detergent	lsd (lysergic acid diethylamide)
mind eraser	flunitrazepam (rohypnol®)
mini beans	amphetamine
mini bennies	amphetamine
mint leaf	pcp (phencyclidine)
mint weed	pcp (phencyclidine)
mira	opium
misk	psilocybin mushrooms
miss emma	morphine
miss girl	methamphetamine
mist	pcp (phencyclidine)
mister blue	morphine
mixed jive	crack cocaine
mochie	hydroponic marijuana
moisqueta	marijuana
mojo	cocaine; heroin
mole	heroin
moña	marijuana
mona lisa	cocaine
mongega	heroin
monkey	morphine
monkey dust	pcp (phencyclidine)
monkey juice	ghb (gamma-hydroxybutyric acid)
monkey tranquilizer	pcp (phencyclidine)
monte	cocaine; marijuana
montura	methamphetamine
moocah	marijuana
moon	mescaline/peyote
moon rock	crack cocaine; ecstasy/mdma/molly
moon rocks	marijuana concentrates/hash oil
mootie	marijuana
mora	marijuana
morena	heroin
morenita	heroin
morning shot	amphetamine
morpho	morphine
morrow	cocaine
mortal combat	heroin
mosquitos	cocaine
mostaza	marijuana
mota	marijuana
mother	marijuana
mother of god	lsd (lysergic acid diethylamide)
motor	methamphetamine
motors	heroin
movie star drug	cocaine
mowing the lawn	marijuana
muchacha	cocaine; methamphetamine
muchachas	oxycodone (oxycontin®, roxicodone®, oxaydo®)
muebles	cocaine
muggie	marijuana
mujer	cocaine; heroin
mujeres	oxycodone (oxycontin®, roxicodone®, oxaydo®)
murcielago	heroin
murder 8	fentanyl and fentanyl derivatives
mureler	lsd (lysergic acid diethylamide)
mushies	psilocybin mushrooms
muzzle	heroin
my brother	marijuana
mystique	synthetic cannabinoids
nails	methamphetamine
nanoo	heroin
napkin	cocaine
narizona	marijuana
nave	lsd (lysergic acid diethylamide)
needle candy	hydromorphone (dilaudid®)
negra	heroin
negra tomasa	heroin
negrita	heroin
new acid	pcp (phencyclidine)
new magic	pcp (phencyclidine)
newspapers	lsd (lysergic acid diethylamide)
nice and easy	heroin
nickle	crack cocaine
nieve	cocaine
night noise	heroin
niña	cocaine
ninja	synthetic cannabinoids
no-doze	methamphetamine
normal	cocaine
northern lights	marijuana
nose candy	cocaine
nose powder	cocaine
nubs	mescaline/peyote
nuggets	amphetamine; crack cocaine
o.j.	marijuana
obama	heroin
o-boy	marijuana
ocean burst	synthetic cathinones
odyssey	synthetic cannabinoids
old lady	cocaine
old steve	heroin
one pot	methamphetamine
one-fifty-one	crack cocaine
opes	fentanyl and fentanyl derivatives
opio	opium
orange barrels	lsd (lysergic acid diethylamide)
orange crush	promethazine
orange crystal	pcp (phencyclidine)
orange cubes	lsd (lysergic acid diethylamide)
orange haze	lsd (lysergic acid diethylamide)
orange micros	lsd (lysergic acid diethylamide)
orange wedges	lsd (lysergic acid diethylamide)
oranges	amphetamine; buprenorphine and naloxone combination (suboxone®)
organic quaalude	ghb (gamma-hydroxybutyric acid)
owsley	lsd (lysergic acid diethylamide)
oxy 80s	oxycodone (oxycontin®, roxicodone®, oxaydo®)
oyster stew	cocaine
ozone	pcp (phencyclidine)
paint	cocaine; methamphetamine
paja	marijuana
pakalolo	marijuana
paleta	cocaine
palitroque	alprazolam (xanax®)
palm	marijuana
paloma	cocaine; marijuana
palomita	marijuana
palomos	cocaine
panama cut	marijuana
panama gold	marijuana
panama red	marijuana
pandora’s box	synthetic cannabinoids
pantalones	cocaine; methamphetamine
pants	heroin
papas	cocaine
paper acid	lsd (lysergic acid diethylamide)
paradise	cocaine
paradise white	cocaine
parrot	cocaine
parsley	marijuana
pastas	amphetamine
paste	crack cocaine
pastillas	amphetamine
pasto	marijuana
pasture	marijuana
patty	heroin
patudas	methamphetamine
paulas	acetaminophen and oxycodone combination (percocet®)
peace	ecstasy/mdma/molly
peace pill	pcp (phencyclidine)
peaches	amphetamine
peanut butter crank	methamphetamine
pearl	cocaine
pearly gates	lsd (lysergic acid diethylamide)
pebbles	crack cocaine
pedrito	cocaine
pedro martinez	crack cocaine
pee wee	crack cocaine
peep	pcp (phencyclidine)
peliroja	marijuana
pellets	lsd (lysergic acid diethylamide)
pelosa	marijuana
pen yan	opium
pep pills	amphetamine
pepper	amphetamine
percs	acetaminophen and oxycodone combination (percocet®)
perico	cocaine
personal	cocaine
peruvian	cocaine
peruvian flake	cocaine
peruvian lady	cocaine
pescado	cocaine
peta	cocaine
peter pan	pcp (phencyclidine)
p-funk	heroin
pharmacy	fentanyl and fentanyl derivatives
phoenix	lsd (lysergic acid diethylamide); marijuana; synthetic cannabinoids
phone screen
cleaner"	synthetic cathinones
pichicata	cocaine
piedras	crack cocaine
piezas	heroin
pig killer	pcp (phencyclidine)
pile	crack cocaine
pillow	cocaine
pimp	cocaine
pin gon	opium
pin yen	opium
piñata	methamphetamine
pine	marijuana
pineapple	methylphenidate (ritalin®, concerta®, daytrana®)
pineapple express	synthetic cannabinoids
pingas	amphetamine; cocaine
pingaz	ecstasy/mdma/molly
pingers	ecstasy/mdma/molly
pingos	cocaine
pingus	flunitrazepam (rohypnol®)
pink	u-47700
pink blotters	lsd (lysergic acid diethylamide)
pink hearts	amphetamine
pink panther	marijuana
pink panthers	lsd (lysergic acid diethylamide)
pink robots	lsd (lysergic acid diethylamide)
pink wedges	lsd (lysergic acid diethylamide)
pink witches	lsd (lysergic acid diethylamide)
pinky	u-47700
pintura	marijuana
pintura blanca	cocaine
pixies	amphetamine
pizza	lsd (lysergic acid diethylamide)
pizza toppings	psilocybin mushrooms
planks	alprazolam (xanax®)
plant	marijuana
plant feeder	synthetic cathinones
plant food	synthetic cathinones
plata	heroin
platinum cookies	hydroponic marijuana
platinum jack	marijuana
pocket rocket	marijuana
pointy ones	methamphetamine
poison	fentanyl and fentanyl derivatives; heroin
poli	cocaine
pollito	methamphetamine
pollo	cocaine
pollutants	amphetamine
polvo	cocaine; heroin
polvo de alegria	heroin
polvo de estrellas	heroin
polvo feliz	heroin
pony	crack cocaine
poor man’s cocaine	methylphenidate (ritalin®, concerta®, daytrana®)
popcorn	marijuana
poppy	heroin
popsicle	methamphetamine
porro	marijuana
posh	synthetic cannabinoids
potato	lsd (lysergic acid diethylamide)
potpourri	synthetic cannabinoids
powder	cocaine; heroin
powder diamonds	cocaine
pretendo	marijuana
primo	crack cocaine
prop 215	marijuana
prostituta negra	heroin
psilly billy	psilocybin mushrooms
puff	marijuana
puffy	pcp (phencyclidine)
puma	cocaine
pumpers	steroids
puppy	heroin
pure	heroin
pure ivory	synthetic cathinones
pure love	lsd (lysergic acid diethylamide)
puritain	cocaine
purple	ketamine (ketalar®); methamphetamine
purple	promethazine
purple barrels	lsd (lysergic acid diethylamide)
purple drank	promethazine
purple haze	lsd (lysergic acid diethylamide); marijuana
purple hearts	amphetamine; lsd (lysergic acid diethylamide)
purple og	marijuana
purple passion	psilocybin mushrooms
purple rain	pcp (phencyclidine)
purple tickets	lsd (lysergic acid diethylamide)
purple wave	synthetic cathinones
quadros	cocaine
quarters	crack cocaine
queen ann’s lace	marijuana
queso blanco	cocaine
r.i.p.	crack cocaine
racehorse charlie	cocaine
ragweed	marijuana
railroad weed	marijuana
rainy day woman	marijuana
rambo	cocaine; heroin
rapture	synthetic cannabinoids
raspado	methamphetamine
rasta weed	marijuana
r-ball	methylphenidate (ritalin®, concerta®, daytrana®)
ready rock	crack cocaine
rechard	synthetic cathinones
red caps	crack cocaine
red chicken	heroin
red cross	marijuana
red devil	pcp (phencyclidine)
red dirt	marijuana
red dove	synthetic cathinones
red eagle	heroin
red hair	marijuana
red magic	synthetic cannabinoids
reefer	marijuana
refrescas	cocaine
refresco	cocaine
reggie	marijuana
regular kind	cocaine
regular work	cocaine
reindeer dust	cocaine; heroin
repollo	marijuana
rest in peace	crack cocaine
rewind	synthetic cannabinoids
reynolds	flunitrazepam (rohypnol®)
rhythm	amphetamine
richie	cocaine
rids	methylphenidate (ritalin®, concerta®, daytrana®)
righteous bush	marijuana
rims	"acetaminophen and oxycodone combination (percocet®); cocaine;
methamphetamine
rippers	amphetamine
rittys	methylphenidate (ritalin®, concerta®, daytrana®)
roach	flunitrazepam (rohypnol®)
road dope	amphetamine
roapies	flunitrazepam (rohypnol®)
roca	crack cocaine
rochas	flunitrazepam (rohypnol®)
rock	crack cocaine
rock attack	crack cocaine
rocket fuel	methamphetamine; pcp (phencyclidine)
rocks of hell	crack cocaine
rocky iii	crack cocaine
rocky mountain	cocaine
roids	steroids
rojo	promethazine
rolex	cocaine
rolex hh	cocaine
rolling	ecstasy/mdma/molly
rolls	ecstasy/mdma/molly
roofies	flunitrazepam (rohypnol®)
roofing tar	heroin
rooster	cocaine; crack cocaine
root	marijuana
rope	marijuana
rophie	flunitrazepam (rohypnol®)
rosa maria	marijuana
roses	amphetamine
ro-shay	flunitrazepam (rohypnol®)
rosin	marijuana concentrates/hash oil
rosin tech	marijuana concentrates/hash oil
roxy	oxycodone (oxycontin®, roxicodone®, oxaydo®)
roxy shorts	oxycodone (oxycontin®, roxicodone®, oxaydo®)
roxyanne	crack cocaine
r-pop	methylphenidate (ritalin®, concerta®, daytrana®)
ruby	heroin
rueda	amphetamine
running	ecstasy/mdma/molly
rupture	pcp (phencyclidine)
sack	heroin
salt	heroin; methamphetamine
salt and pepper	marijuana
salting	synthetic cathinones
salty water	ghb (gamma-hydroxybutyric acid)
san pedro	mescaline/peyote
sand	heroin
santa maria	marijuana
sasafras	marijuana
sativa	marijuana
sauce	marijuana concentrates/hash oil
scag	heroin
scale	cocaine
scarface	synthetic cathinones
scat	heroin
schmeck	cocaine; heroin
school bus	alprazolam (xanax®)
schoolboy	cocaine
schoolcraft	crack cocaine
scooby snacks	ecstasy/mdma/molly
scooby snax	synthetic cannabinoids
scoop	ghb (gamma-hydroxybutyric acid)
scorpion	cocaine
scottie	cocaine
scotty	crack cocaine
scramble	crack cocaine; uncut heroin
scratch	hydrocodone (norco®, vicodin®, lorcet®)
scruples	crack cocaine
scuffle	pcp (phencyclidine)
seed	cocaine
seni	mescaline/peyote
serpico	cocaine
seven-up	crack cocaine
sexy	synthetic cannabinoids
shabu	methamphetamine
shaman	mescaline/peyote
shards	methamphetamine
shatter	marijuana concentrates/hash oil; methamphetamine
shaved ice	methamphetamine
sheep	heroin
sheets	pcp (phencyclidine)
sherms	crack cocaine; pcp (phencyclidine)
shermstick	pcp (phencyclidine)
shiny girl	methamphetamine
shirt	cocaine
shirts	heroin
shmagma	marijuana
shoes	fentanyl and fentanyl derivatives; heroin; marijuana
shora	marijuana
shrimp	marijuana
shwag	marijuana
sierra	cocaine
sight ball	crack cocaine
silly putty	psilocybin mushrooms
simple simon	psilocybin mushrooms
sinsemilla	marijuana
sizurup	promethazine
sizzurp	promethazine
skag	heroin
skee	opium
ski equipment	cocaine
skippy	methylphenidate (ritalin®, concerta®, daytrana®)
skittle	ecstasy/mdma/molly
skittles	methylphenidate (ritalin®, concerta®, daytrana®); promethazine
skunk	heroin; marijuana
sky high	synthetic cannabinoids
skywalker	hydroponic marijuana
slab	crack cocaine
sleet	crack cocaine
sleigh ride	cocaine
slime	heroin
slits	ecstasy/mdma/molly
smack	heroin
smacks	ecstasy/mdma/molly
small girl	methamphetamine
smart pills	amphetamine and dextroamphetamine combination (adderall®)
smarties	"amphetamine and dextroamphetamine combination (adderall®);
ecstasy/mdma/molly; methylphenidate (ritalin®, concerta®, daytrana®)"
smeck	heroin
smoke	crack cocaine; marijuana
smoke canada	marijuana
smoochy woochy
poochy"	marijuana
snake bite	synthetic cannabinoids
snaps	amphetamine
sneeze	cocaine
snickers	heroin
sniff	cocaine
snow	cocaine
snow bird	cocaine
snow cone	cocaine
snow leopard	synthetic cathinones
snow pallets	amphetamine
snow white	cocaine
snowball	cocaine
snowflake	cocaine; fentanyl and fentanyl derivatives
soap	ghb (gamma-hydroxybutyric acid)
soap dope	methamphetamine
sobos	buprenorphine and naloxone combination (suboxone®)
society high	cocaine
soda	cocaine; heroin
soditas	cocaine
soft	cocaine
soft ones	methamphetamine
solar flare	synthetic cannabinoids
solventless	marijuana concentrates/hash oil
sour og	marijuana
space	cocaine mixed with pcp
sparkle plenty	amphetamine
sparklers	amphetamine
special	cocaine
special k	ketamine (ketalar®)
special la coke	ketamine (ketalar®)
speed	amphetamine; methamphetamine
speed boat	crack cocaine
speed dog	methamphetamine
speed for lovers	ecstasy/mdma/molly
speedball	cocaine mixed with heroin
spice	synthetic cannabinoids
spicy kind	methamphetamine
spider blue	heroin
spike diamond	synthetic cannabinoids
spin	methamphetamine
spit and die	lsd (lysergic acid diethylamide)
splash	amphetamine
spliff	marijuana
spores	pcp (phencyclidine)
square time bomb	crack cocaine
stackers	steroids
"star spangled
powder"	cocaine
stardust	cocaine; pcp (phencyclidine); synthetic cathinones
stemmies	psilocybin mushrooms
stems	marijuana
sticks	alprazolam (xanax®)
sticky	marijuana
sticky kind	heroin
stink weed	marijuana
stone	crack cocaine
stop signs	buprenorphine and naloxone combination (suboxone®)
stops	buprenorphine and naloxone combination (suboxone®)
storm	synthetic cannabinoids
stove top	methamphetamine
studio fuel	cocaine
study buddies	"amphetamine and dextroamphetamine combination (adderall®);
methylphenidate (ritalin®, concerta®, daytrana®)
study skittles	amphetamine and dextroamphetamine combination (adderall®)
stufa	heroin
stuff	methamphetamine
suave	cocaine
subs	buprenorphine and naloxone combination (suboxone®)
sugar	cocaine; heroin
sugar block	crack cocaine
sugar cubes	lsd (lysergic acid diethylamide)
sugar lumps	lsd (lysergic acid diethylamide)
sugar weed	marijuana
sunshine	lsd (lysergic acid diethylamide)
super acid	ketamine (ketalar®)
super c	ketamine (ketalar®)
super grass	pcp (phencyclidine)
super ice	methamphetamine
super kools	pcp (phencyclidine)
super valium	clonazepam (klonopin®)
super weed	pcp (phencyclidine)
superman	cocaine; lsd (lysergic acid diethylamide)
surfer	pcp (phencyclidine)
sweet jesus	heroin
sweet leaf	synthetic cannabinoids
sweet lucy	marijuana
sweet stuff	cocaine
sweeties	amphetamine
sweets	amphetamine; ecstasy/mdma/molly
synthetic cocaine	pcp (phencyclidine)
synthetic marijuana	synthetic cannabinoids
syrup	promethazine
tabique	cocaine
tablas	cocaine
table	methamphetamine
tabs	"hydrocodone (norco®, vicodin®, lorcet®); lsd (lysergic acid
diethylamide)"
tacatosa	lsd (lysergic acid diethylamide)
tacha	ecstasy/mdma/molly
tahoe	hydroponic marijuana
tail lights	lsd (lysergic acid diethylamide)
takeover	crack cocaine mixed with fentanyl
taking a cruise	pcp (phencyclidine)
talco	cocaine
talquito	cocaine
tamales	cocaine
tango and cash	fentanyl and fentanyl derivatives
tangy og	marijuana
taxi	cocaine
t-buzz	pcp (phencyclidine)
tecata	heroin
tecate	cocaine
teddy bears	lsd (lysergic acid diethylamide)
teenager	cocaine
teeth	cocaine; crack cocaine
tens	amphetamine
tension	crack cocaine
tequila	cocaine
terp	marijuana
terp sauce	marijuana concentrates/hash oil
terpenes	marijuana
terraband	synthetic cannabinoids
texas tea	marijuana
tex-mex	marijuana
thca	marijuana concentrates/hash oil
thca crystal	marijuana concentrates/hash oil
thca crystalline	marijuana concentrates/hash oil
thca powder	marijuana concentrates/hash oil
thizz	ecstasy/mdma/molly
thrusters	amphetamine
thunder	cocaine; heroin
tic tac	pcp (phencyclidine)
ticket	lsd (lysergic acid diethylamide)
tigitty	marijuana
tila	marijuana
time traveler	synthetic cannabinoids
tims	marijuana
tina	methamphetamine
tire	cocaine
tires	"acetaminophen and oxycodone combination (percocet®); heroin;
methamphetamine"
tish	pcp (phencyclidine)
tissue	crack cocaine
toe tag dope	fentanyl and fentanyl derivatives
tomasa	heroin
tonto	cocaine
toot	cocaine
tootsie roll	heroin
top gear	synthetic cannabinoids
top gun	crack cocaine
top shelf	marijuana
topi	mescaline/peyote
tops	mescaline/peyote
tortes	cocaine
tortuga	cocaine
tosca	marijuana
toxy	opium
toyota	cocaine
toys	opium
tr-6s	amphetamine
tragic magic	heroin
train wreck	marijuana; synthetic cannabinoids
tranks	clonazepam (klonopin®); pcp (phencyclidine)
trash	methamphetamine
trees	heroin; marijuana
trichrome	marijuana concentrates/hash oil
trinity og	marijuana
trip-and-fall	flunitrazepam (rohypnol®)
triple v	vicodin® taken with valium® and vodka
troop	crack cocaine
truck	methamphetamine
truck drivers	"amphetamine; amphetamine and dextroamphetamine combination
(adderall®); methylphenidate (ritalin®, concerta®, daytrana®)"
t-shirts	cocaine
tubo	cocaine
tucibi	cocaine - pink variety
tupperware	methamphetamine
turkey	cocaine
turn abouts	amphetamine
turtle	heroin
tutti fruitti	cocaine
tweak	methamphetamine
tweeds	marijuana
tweezes	psilocybin mushrooms
ultimate	crack cocaine; synthetic cannabinoids
unassembled	powder methamphetamine
uncle sid	lsd (lysergic acid diethylamide)
unkie	morphine
upjohns	alprazolam (xanax®)
uppers	amphetamine; methamphetamine
valle	marijuana
valley dolls	lsd (lysergic acid diethylamide)
vanilla sky	synthetic cathinones
vaquita	cocaine
veeks	hydrocodone (norco®, vicodin®, lorcet®)
velvet	promethazine
venom	pcp (phencyclidine)
ventanas	methamphetamine
vics	hydrocodone (norco®, vicodin®, lorcet®)
vidrio	heroin; methamphetamine
vikes	hydrocodone (norco®, vicodin®, lorcet®)
viper	synthetic cannabinoids
vitamin e	ecstasy/mdma/molly
vitamin k	ketamine (ketalar®)
vitamin r	methylphenidate (ritalin®, concerta®, daytrana®)
vodka acid	lsd (lysergic acid diethylamide)
voodoo chils	synthetic cannabinoids
vowels	ecstasy/mdma/molly
wack	pcp mixed with cocaine
wake and bake	marijuana
wake ups	amphetamine
walking zombie	methamphetamine
wash	cocaine
water	"ghb (gamma-hydroxybutyric acid); methamphetamine; pcp
(phencyclidine)"
watsons	hydrocodone (norco®, vicodin®, lorcet®)
wave	crack cocaine
wazabi	synthetic cannabinoids
wazz	methamphetamine
wedding bells	lsd (lysergic acid diethylamide)
wedge	lsd (lysergic acid diethylamide)
weed	marijuana
weed tea	marijuana
weight gainers	steroids
weights	heroin
west coast
turnarounds"	amphetamine
whack	cocaine mixed with pcp
wheat	marijuana
wheels	acetaminophen and oxycodone combination (percocet®); amphetamine
when-shee	opium
whiffle dust	amphetamine
whisky	heroin
white	cocaine; heroin
white ball	crack cocaine
white bitch	cocaine
white boy	heroin
white boys	alprazolam (xanax®)
white cross	cocaine
white crosses	amphetamine
white dove	cocaine; synthetic cathinones
white dust	lsd (lysergic acid diethylamide)
white fluff	lsd (lysergic acid diethylamide)
white ghost	crack cocaine
white girl	heroin; fentanyl and fentanyl derivatives
white girls	alprazolam (xanax®); cocaine
white goat	cocaine
white horizon	pcp (phencyclidine)
white horse	cocaine
white junk	heroin
white knight	synthetic cathinones
white ladies	fentanyl and fentanyl derivatives
white lady	cocaine; heroin
white lightening	lsd (lysergic acid diethylamide); synthetic cathinones
white magic	synthetic cathinones
white mercedes	ecstasy/mdma/molly
"white mercedes
benz"	cocaine
white mosquito	cocaine
white nurse	heroin
white owsley	lsd (lysergic acid diethylamide)
white paint	cocaine
white powder	cocaine
white rock	cocaine
white root	cocaine
white shirt	cocaine; heroin
white stuff	heroin; morphine
white sugar	crack cocaine
white t	cocaine
white tornado	crack cocaine
white wall tires	cocaine
white whizz	methamphetamine
white-haired lady	marijuana
whites	amphetamine; oxycodone (oxycontin®, roxicodone®, oxaydo®)
whitey	cocaine
whiz bang	cocaine
wicked	synthetic cannabinoids
wicked x	synthetic cathinones
window glass	lsd (lysergic acid diethylamide)
window pane	lsd (lysergic acid diethylamide)
windows	methamphetamine
wings	cocaine; heroin
witch	heroin
witch hazel	heroin
witches teeth	methamphetamine
wizard	synthetic cannabinoids
wobble	ketamine (ketalar®)
wobble weed	pcp (phencyclidine)
wolfies	flunitrazepam (rohypnol®); pcp (phencyclidine)
wonky	ketamine (ketalar®)
wooly	cocaine
wooz	marijuana
work	cocaine
worm	pcp (phencyclidine)
wrecking crew	crack cocaine
xanies	alprazolam (xanax®)
xtreme	synthetic cannabinoids
yaba	methamphetamine
yahoo	crack cocaine
yale	crack cocaine
yayo	cocaine
yellow barn	methamphetamine
yellow boys	alprazolam (xanax®)
yellow cake	methamphetamine
yellow dimples	lsd (lysergic acid diethylamide)
yellow fever	pcp (phencyclidine)
yellow kind	methamphetamine
yellow submarine	marijuana
yellow sunshine	lsd (lysergic acid diethylamide)
yen pop	marijuana
yerba	marijuana
yesca	marijuana
yeyo	cocaine
yimyom	crack cocaine
yoda	cocaine
yokes	ecstasy/mdma/molly
young girls	marijuana
yucatan	synthetic cannabinoids
yucatan fire	synthetic cannabinoids
zacate	marijuana
zacatecas	marijuana
zambi	marijuana
zanbars	alprazolam (xanax®)
zannies	alprazolam (xanax®)
zapapote	heroin
zapato	cocaine
z-bars	alprazolam (xanax®)
zero	opium
zero gravity	synthetic cannabinoids
zing	amphetamine and dextroamphetamine combination (adderall®)
zohai	synthetic cannabinoids
zombie	pcp (phencyclidine); synthetic cannabinoids
zoom	marijuana mixed with pcp; synthetic cathinones
zoomers	amphetamine
